name Bot Testing
win -3
###########
#.........#
#.........#
#...####..#
#..####...#
#.........#
#.........#
###########